[
    {
        "spawnPoints": [[0,0],[8,0],[16, 0]],
        "playerSpawnsPos": [{"x": 6, "y": 9}, {"x": 10, "y": 9}],
        "basePos": {"x": 16, "y": 18},
        "npc": [0,0,0,0,1,1,0,0,0,0,1,1,0,1,1,0,0,1,0,1],
        "map": [[0,0, 0,0, 0,0, 0,0, 0,0, 2,2, 0,0, 0,0, 0,0, 2,2, 0,0, 0,0, 0,0, 0,0, 0,0, 0,0, 0,0],
                [0,0, 0,0, 0,0, 0,0, 0,0, 2,2, 0,0, 0,0, 0,0, 2,2, 0,0, 0,0, 0,0, 0,0, 0,0, 0,0, 0,0],

                [0,0, 1,1, 0,0, 2,2, 0,0, 1,1, 0,0, 0,0, 0,0, 1,1, 0,0, 1,1, 0,0, 1,1, 0,0, 1,1, 0,0],
                [0,0, 1,1, 0,0, 2,2, 0,0, 1,1, 0,0, 0,0, 0,0, 1,1, 0,0, 1,1, 0,0, 1,1, 0,0, 1,1, 0,0],

                [0,0, 1,1, 0,0, 0,0, 0,0, 1,1, 0,0, 0,0, 1,1, 1,1, 0,0, 1,1, 0,0, 1,1, 2,2, 1,1, 0,0],
                [0,0, 1,1, 0,0, 0,0, 0,0, 1,1, 0,0, 0,0, 1,1, 1,1, 0,0, 1,1, 0,0, 1,1, 2,2, 1,1, 0,0],

                [0,0, 0,0, 0,0, 1,1, 0,0, 0,0, 0,0, 0,0, 2,2, 0,0, 0,0, 0,0, 0,0, 2,2, 4,4, 0,0, 0,0],
                [0,0, 0,0, 0,0, 1,1, 0,0, 0,0, 0,0, 0,0, 2,2, 0,0, 0,0, 0,0, 0,0, 2,2, 4,4, 0,0, 0,0],

                [0,0, 0,0, 0,0, 0,0, 0,0, 0,0, 0,0, 0,0, 0,0, 0,0, 2,2, 0,0, 0,0, 0,0, 4,4, 3,3, 3,3],
                [0,0, 0,0, 0,0, 0,0, 0,0, 0,0, 0,0, 0,0, 0,0, 0,0, 2,2, 0,0, 0,0, 0,0, 4,4, 3,3, 3,3],

                [4,4, 4,4, 1,1, 1,1, 3,3, 1,1, 4,4, 4,4, 4,4, 2,2, 0,0, 0,0, 1,1, 1,1, 0,0, 1,1, 1,1],
                [4,4, 4,4, 1,1, 1,1, 3,3, 1,1, 4,4, 4,4, 4,4, 2,2, 0,0, 0,0, 1,1, 1,1, 0,0, 0,0, 0,0],

                [0,0, 0,0, 0,0, 0,0, 0,0, 2,2, 4,4, 1,1, 0,0, 1,1, 0,0, 0,0, 0,0, 0,0, 0,0, 0,0, 0,0],
                [0,0, 0,0, 0,0, 0,0, 0,0, 2,2, 4,4, 1,1, 0,0, 1,1, 0,0, 0,0, 0,0, 0,0, 0,0, 1,1, 0,0],

                [2,2, 1,1, 1,1, 1,1, 0,0, 1,1, 0,0, 1,1, 1,1, 1,1, 0,0, 1,1, 1,1, 1,1, 2,2, 1,1, 4,4],
                [2,2, 1,1, 1,1, 1,1, 0,0, 1,1, 0,0, 1,1, 1,1, 1,1, 0,0, 1,1, 1,1, 1,1, 2,2, 1,1, 4,4],

                [0,0, 1,1, 1,1, 1,1, 0,0, 0,0, 0,0, 0,0, 0,0, 0,0, 0,0, 0,0, 0,0, 0,0, 0,0, 0,0, 4,4],
                [0,0, 1,1, 1,1, 1,1, 0,0, 0,0, 0,0, 0,1, 1,1, 1,0, 0,0, 0,0, 0,0, 0,0, 0,0, 0,0, 4,4],

                [0,0, 1,1, 1,1, 1,1, 0,0, 1,1, 0,0, 0,1, 9,9, 1,0, 0,0, 1,1, 1,1, 1,1, 1,1, 1,1, 0,0],
                [0,0, 1,1, 1,1, 1,1, 0,0, 1,1, 0,0, 0,1, 9,9, 1,0, 0,0, 1,1, 1,1, 1,1, 1,1, 1,1, 0,0]]
    },
    {
        "spawnPoints": [[0,0],[8,0],[16, 0]],
        "playerSpawnsPos": [{"x": 12, "y": 9}, {"x": 14, "y": 9}],
        "basePos": {"x": 0, "y": 18},
        "npc": [0,0,0,0,1,1,0,0,0,0],
        "map": [[0,0, 0,0, 0,0, 0,0, 0,0, 0,0, 0,0, 0,0, 0,0, 0,0, 0,0, 0,0, 0,0, 0,0, 0,0, 0,0, 0,0],
                [0,0, 0,0, 0,0, 0,0, 0,0, 0,0, 0,0, 0,0, 0,0, 0,0, 0,0, 0,0, 0,0, 0,0, 0,0, 0,0, 0,0],

                [0,0, 1,1, 1,1, 0,0, 0,0, 0,0, 1,1, 1,1, 0,0, 0,0, 0,0, 0,0, 0,0, 0,0, 0,0, 0,0, 0,0],
                [0,0, 1,1, 1,1, 0,0, 0,0, 0,0, 1,1, 1,1, 0,0, 0,0, 0,0, 0,0, 0,0, 0,0, 0,0, 0,0, 0,0],

                [0,0, 0,0, 0,0, 0,0, 0,0, 0,0, 0,0, 0,0, 0,0, 0,0, 0,0, 0,0, 0,0, 1,1, 0,0, 0,0, 0,0],
                [0,0, 0,0, 0,0, 0,0, 0,0, 0,0, 0,0, 0,0, 0,0, 0,0, 0,0, 0,0, 0,0, 1,1, 0,0, 0,0, 0,0],

                [0,0, 0,0, 0,0, 0,0, 0,0, 0,0, 0,0, 0,0, 0,0, 0,0, 0,0, 0,0, 0,0, 0,0, 0,0, 0,0, 0,0],
                [0,0, 0,0, 0,0, 0,0, 0,0, 0,0, 0,0, 0,0, 0,0, 0,0, 0,0, 0,0, 0,0, 0,0, 0,0, 0,0, 0,0],

                [0,0, 0,0, 1,1, 0,0, 0,0, 0,0, 0,0, 0,0, 0,0, 0,0, 0,0, 0,0, 0,0, 1,1, 0,0, 0,0, 0,0],
                [0,0, 0,0, 1,1, 0,0, 0,0, 0,0, 0,0, 1,1, 1,1, 0,0, 0,0, 0,0, 0,0, 1,1, 0,0, 0,0, 0,0],

                [1,1, 1,1, 1,1, 0,0, 0,0, 1,1, 1,1, 1,1, 1,1, 1,1, 1,1, 0,0, 0,0, 1,1, 0,0, 0,0, 0,0],
                [1,1, 1,1, 1,1, 0,0, 0,0, 1,1, 1,1, 1,1, 1,1, 1,1, 1,1, 0,0, 0,0, 1,1, 0,0, 0,0, 0,0],

                [0,0, 0,0, 0,0, 0,0, 0,0, 0,0, 0,0, 0,0, 0,0, 0,0, 1,1, 0,0, 0,0, 1,1, 0,0, 0,0, 0,0],
                [0,0, 0,0, 0,0, 0,0, 0,0, 0,0, 0,0, 0,0, 0,0, 0,0, 1,1, 0,0, 0,0, 1,1, 0,0, 0,0, 0,0],

                [0,0, 0,0, 0,0, 0,0, 0,0, 0,0, 0,0, 0,0, 0,0, 0,0, 1,1, 0,0, 0,0, 1,1, 0,0, 0,0, 0,0],
                [0,0, 0,0, 0,0, 0,0, 0,0, 0,0, 0,0, 0,0, 0,0, 0,0, 1,1, 0,0, 0,0, 1,1, 0,0, 0,0, 0,0],

                [1,1, 1,1, 0,0, 0,0, 0,0, 1,1, 1,1, 0,0, 0,0, 0,0, 0,0, 0,0, 0,0, 0,0, 0,0, 0,0, 0,0],
                [1,1, 1,1, 0,0, 0,0, 0,0, 1,1, 1,1, 0,0, 0,0, 0,0, 0,0, 0,0, 0,0, 0,0, 0,0, 0,0, 0,0],

                [9,9, 1,1, 0,0, 0,0, 1,1, 1,1, 0,0, 0,0, 0,0, 0,0, 0,0, 0,0, 0,0, 0,0, 0,0, 0,0, 0,0],
                [9,9, 1,1, 0,0, 0,0, 1,1, 1,1, 0,0, 0,0, 0,0, 0,0, 0,0, 0,0, 0,0, 0,0, 0,0, 0,0, 0,0]]
    } 
]