[
    {
        "spawnPoints": [[1,1],[7,1],[11, 1]],
        "playerSpawnPos1": {"x": 11, "y": 10},
        "countNpc": 10,
        "map": [[0,0, 0,0, 1,1, 1,1, 1,1, 1,1, 0,0, 0,0, 0,0, 0,0, 0,0, 0,0, 0,0],
                [0,0, 0,0, 1,1, 1,1, 1,1, 1,1, 0,0, 0,0, 0,0, 0,0, 0,0, 0,0, 0,0],
       
                [0,0, 0,0, 1,1, 1,1, 0,0, 0,0, 0,0, 0,0, 0,0, 0,0, 0,0, 0,0, 0,0],
                [0,0, 0,0, 1,1, 1,1, 0,0, 0,0, 0,0, 0,0, 0,0, 0,0, 0,0, 0,0, 0,0],
       
                [0,0, 0,0, 1,1, 1,1, 0,0, 0,0, 1,1, 1,1, 0,0, 0,0, 0,0, 0,0, 0,0],
                [0,0, 0,0, 1,1, 1,1, 0,0, 0,0, 1,1, 1,1, 0,0, 0,0, 0,0, 0,0, 0,0],
       
                [0,0, 0,0, 1,1, 1,1, 0,0, 0,0, 0,0, 0,0, 0,0, 0,0, 0,0, 0,0, 0,0],
                [0,0, 0,0, 1,1, 1,1, 0,0, 0,0, 0,0, 0,0, 0,0, 0,0, 0,0, 0,0, 0,0],
       
                [0,0, 0,0, 0,0, 0,0, 0,0, 0,0, 2,2, 2,2, 0,0, 0,0, 0,0, 0,0, 0,0],
                [0,0, 0,0, 0,0, 0,0, 0,0, 0,0, 2,2, 2,2, 0,0, 0,0, 0,0, 0,0, 0,0],
       
                [0,0, 0,0, 1,1, 1,1, 0,0, 0,0, 2,2, 2,2, 0,0, 0,0, 0,0, 0,0, 0,0],
                [0,0, 0,0, 1,1, 1,1, 0,0, 0,0, 2,2, 2,2, 0,0, 0,0, 0,0, 0,0, 0,0],
       
                [0,0, 0,0, 1,1, 1,1, 0,0, 0,0, 0,0, 0,0, 0,0, 2,2, 0,0, 0,0, 0,0],
                [0,0, 0,0, 1,1, 1,1, 0,0, 0,0, 0,0, 0,0, 0,0, 2,2, 0,0, 0,0, 0,0],
       
                [0,0, 0,0, 1,1, 1,1, 1,1, 1,1, 0,0, 0,0, 0,0, 2,2, 0,0, 2,2, 0,0],
                [0,0, 0,0, 1,1, 1,1, 1,1, 1,1, 0,0, 0,0, 0,0, 2,2, 0,0, 2,2, 0,0],
       
                [0,0, 0,0, 2,2, 2,2, 0,0, 0,0, 0,0, 0,0, 0,0, 0,0, 0,0, 0,0, 0,0],
                [0,0, 0,0, 2,2, 2,2, 0,0, 0,0, 0,0, 0,0, 0,0, 0,0, 0,0, 0,0, 0,0],
       
                [0,0, 0,0, 1,1, 1,1, 0,0, 0,0, 0,0, 0,0, 0,0, 0,0, 0,0, 0,0, 0,0],
                [0,0, 0,0, 1,1, 1,1, 0,0, 0,0, 0,0, 0,0, 0,0, 0,0, 0,0, 0,0, 0,0],
       
                [0,0, 0,0, 1,1, 1,1, 0,0, 0,0, 0,0, 0,0, 0,0, 0,0, 0,0, 0,0, 0,0],
                [0,0, 0,0, 1,1, 1,1, 0,0, 0,0, 0,0, 0,0, 0,0, 0,0, 0,0, 0,0, 0,0],
       
                [0,0, 0,0, 1,1, 1,1, 1,1, 1,1, 0,0, 0,0, 0,0, 0,0, 0,0, 0,0, 0,0],
                [0,0, 0,0, 1,1, 1,1, 1,1, 1,1, 0,0, 0,0, 0,0, 0,0, 0,0, 0,0, 0,0],
       
                [0,0, 0,0, 1,1, 1,1, 1,0, 0,0, 0,0, 0,0, 0,0, 0,0, 0,0, 0,0, 0,0],
                [0,0, 0,0, 1,1, 1,1, 1,0, 0,0, 0,0, 0,0, 0,0, 0,0, 0,0, 0,0, 0,0]]
    } 
]