[
    {
        "spawnPoints": [[0,0],[8,0],[16, 0]],
        "playerSpawnsPos": [{"x": 6, "y": 9}, {"x": 10, "y": 9}],
        "basePos": {"x": 8, "y": 9},
        "countNpc": 11,
        "map": [[0,0, 0,0, 0,0, 2,2, 0,0, 2,2, 0,0, 0,0, 0,0, 2,2, 0,0, 0,0, 0,0, 0,0, 0,0, 0,0, 0,0],
                [0,0, 0,0, 0,0, 2,2, 0,0, 2,2, 0,0, 0,0, 0,0, 2,2, 0,0, 0,0, 0,0, 0,0, 0,0, 0,0, 0,0],

                [0,0, 2,2, 0,0, 2,2, 0,0, 2,2, 0,0, 0,0, 0,0, 2,2, 0,0, 2,2, 0,0, 2,2, 0,0, 2,2, 0,0],
                [0,0, 2,2, 0,0, 2,2, 0,0, 2,2, 0,0, 0,0, 0,0, 2,2, 0,0, 2,2, 0,0, 2,2, 0,0, 2,2, 0,0],

                [0,0, 2,2, 0,0, 0,0, 0,0, 2,2, 0,0, 0,0, 2,2, 2,2, 0,0, 2,2, 0,0, 2,2, 2,2, 2,2, 0,0],
                [0,0, 2,2, 0,0, 0,0, 0,0, 2,2, 0,0, 0,0, 2,2, 2,2, 0,0, 2,2, 0,0, 2,2, 2,2, 2,2, 0,0],

                [0,0, 0,0, 0,0, 2,2, 0,0, 0,0, 0,0, 0,0, 0,0, 0,0, 0,0, 0,0, 0,0, 2,2, 0,0, 0,0, 0,0],
                [0,0, 0,0, 0,0, 2,2, 0,0, 0,0, 0,0, 0,0, 0,0, 0,0, 0,0, 0,0, 0,0, 2,2, 0,0, 0,0, 0,0],

                [0,0, 0,0, 0,0, 0,0, 0,0, 0,0, 0,0, 0,0, 0,0, 0,0, 2,2, 0,0, 0,0, 0,0, 0,0, 1,1, 1,1],
                [0,0, 0,0, 0,0, 0,0, 0,0, 0,0, 0,0, 0,0, 0,0, 0,0, 2,2, 0,0, 0,0, 0,0, 0,0, 1,1, 1,1],

                [1,1, 1,1, 2,2, 2,2, 2,2, 2,2, 0,0, 0,0, 0,0, 2,2, 0,0, 0,0, 2,2, 2,2, 0,0, 2,2, 2,2],
                [1,1, 1,1, 2,2, 2,2, 2,2, 2,2, 0,0, 0,0, 0,0, 2,2, 0,0, 0,0, 2,2, 2,2, 0,0, 0,0, 0,0],

                [0,0, 0,0, 0,0, 0,0, 0,0, 2,2, 0,0, 2,2, 0,0, 2,2, 0,0, 0,0, 0,0, 0,0, 0,0, 0,0, 0,0],
                [0,0, 0,0, 0,0, 0,0, 0,0, 2,2, 0,0, 2,2, 0,0, 2,2, 0,0, 0,0, 0,0, 0,0, 0,0, 2,2, 0,0],

                [2,2, 2,2, 2,2, 2,2, 0,0, 2,2, 0,0, 2,2, 2,2, 2,2, 0,0, 2,2, 2,2, 2,2, 2,2, 2,2, 0,0],
                [2,2, 2,2, 2,2, 2,2, 0,0, 2,2, 0,0, 2,2, 2,2, 2,2, 0,0, 2,2, 2,2, 2,2, 2,2, 2,2, 0,0],

                [0,0, 2,2, 2,2, 2,2, 0,0, 0,0, 0,0, 0,0, 0,0, 0,0, 0,0, 0,0, 0,0, 0,0, 0,0, 0,0, 0,0],
                [0,0, 2,2, 2,2, 2,2, 0,0, 0,0, 0,0, 0,2, 2,2, 2,0, 0,0, 0,0, 0,0, 0,0, 0,0, 0,0, 0,0],

                [0,0, 2,2, 2,2, 2,2, 0,0, 2,2, 0,0, 0,2, 0,0, 2,0, 0,0, 2,2, 2,2, 2,2, 2,2, 2,2, 0,0],
                [0,0, 2,2, 2,2, 2,2, 0,0, 2,2, 0,0, 0,2, 0,0, 2,0, 0,0, 2,2, 2,2, 2,2, 2,2, 2,2, 0,0]]
    },
    {
        "spawnPoints": [[0,0],[8,0],[16, 0]],
        "playerSpawnsPos": [{"x": 12, "y": 9}, {"x": 14, "y": 9}],
        "basePos": {"x": 0, "y": 9},
        "countNpc": 12,
        "map": [[0,0, 0,0, 0,0, 0,0, 0,0, 0,0, 0,0, 0,0, 0,0, 0,0, 0,0, 0,0, 0,0, 0,0, 0,0, 0,0, 0,0],
                [0,0, 0,0, 0,0, 0,0, 0,0, 0,0, 0,0, 0,0, 0,0, 0,0, 0,0, 0,0, 0,0, 0,0, 0,0, 0,0, 0,0],

                [0,0, 2,2, 2,2, 0,0, 0,0, 0,0, 2,2, 2,2, 0,0, 0,0, 0,0, 0,0, 0,0, 0,0, 0,0, 0,0, 0,0],
                [0,0, 2,2, 2,2, 0,0, 0,0, 0,0, 2,2, 2,2, 0,0, 0,0, 0,0, 0,0, 0,0, 0,0, 0,0, 0,0, 0,0],

                [0,0, 0,0, 0,0, 0,0, 0,0, 0,0, 0,0, 0,0, 0,0, 0,0, 0,0, 0,0, 0,0, 2,2, 0,0, 0,0, 0,0],
                [0,0, 0,0, 0,0, 0,0, 0,0, 0,0, 0,0, 0,0, 0,0, 0,0, 0,0, 0,0, 0,0, 2,2, 0,0, 0,0, 0,0],

                [0,0, 0,0, 0,0, 0,0, 0,0, 0,0, 0,0, 0,0, 0,0, 0,0, 0,0, 0,0, 0,0, 0,0, 0,0, 0,0, 0,0],
                [0,0, 0,0, 0,0, 0,0, 0,0, 0,0, 0,0, 0,0, 0,0, 0,0, 0,0, 0,0, 0,0, 0,0, 0,0, 0,0, 0,0],

                [0,0, 0,0, 2,2, 0,0, 0,0, 0,0, 0,0, 0,0, 0,0, 0,0, 0,0, 0,0, 0,0, 2,2, 0,0, 0,0, 0,0],
                [0,0, 0,0, 2,2, 0,0, 0,0, 0,0, 0,0, 2,2, 2,2, 0,0, 0,0, 0,0, 0,0, 2,2, 0,0, 0,0, 0,0],

                [2,2, 2,2, 2,2, 0,0, 0,0, 2,2, 2,2, 2,2, 2,2, 2,2, 2,2, 0,0, 0,0, 2,2, 0,0, 0,0, 0,0],
                [2,2, 2,2, 2,2, 0,0, 0,0, 2,2, 2,2, 2,2, 2,2, 2,2, 2,2, 0,0, 0,0, 2,2, 0,0, 0,0, 0,0],

                [0,0, 0,0, 0,0, 0,0, 0,0, 0,0, 0,0, 0,0, 0,0, 0,0, 2,2, 0,0, 0,0, 2,2, 0,0, 0,0, 0,0],
                [0,0, 0,0, 0,0, 0,0, 0,0, 0,0, 0,0, 0,0, 0,0, 0,0, 2,2, 0,0, 0,0, 2,2, 0,0, 0,0, 0,0],

                [0,0, 0,0, 0,0, 0,0, 0,0, 0,0, 0,0, 0,0, 0,0, 0,0, 2,2, 0,0, 0,0, 2,2, 0,0, 0,0, 0,0],
                [0,0, 0,0, 0,0, 0,0, 0,0, 0,0, 0,0, 0,0, 0,0, 0,0, 2,2, 0,0, 0,0, 2,2, 0,0, 0,0, 0,0],

                [2,2, 2,2, 0,0, 0,0, 0,0, 2,2, 2,2, 0,0, 0,0, 0,0, 0,0, 0,0, 0,0, 0,0, 0,0, 0,0, 0,0],
                [2,2, 2,2, 0,0, 0,0, 0,0, 2,2, 2,2, 0,0, 0,0, 0,0, 0,0, 0,0, 0,0, 0,0, 0,0, 0,0, 0,0],

                [0,0, 2,2, 0,0, 0,0, 2,2, 2,2, 0,0, 0,0, 0,0, 0,0, 0,0, 0,0, 0,0, 0,0, 0,0, 0,0, 0,0],
                [0,0, 2,2, 0,0, 0,0, 2,2, 2,2, 0,0, 0,0, 0,0, 0,0, 0,0, 0,0, 0,0, 0,0, 0,0, 0,0, 0,0]]
    } 
]