[
    {
        "spawnPoints": [[0,0],[16,0],[32, 0]],
        "playerSpawnsPos": [{"x": 12, "y": 18}, {"x": 20, "y": 18}],
        "basePos": {"x": 16, "y": 18},
        "npc": [0,0,0,0,1,1,0,0,0,0,1,1,0,1,1,0,0,1,0,1],
        "map": [[0,0, 0,0, 0,0, 0,0, 0,0, 2,2, 0,0, 0,0, 0,0, 2,2, 0,0, 0,0, 0,0, 0,0, 0,0, 0,0, 0,0],
                [0,0, 0,0, 0,0, 0,0, 0,0, 2,2, 0,0, 0,0, 0,0, 2,2, 0,0, 0,0, 0,0, 0,0, 0,0, 0,0, 0,0],

                [0,0, 1,1, 0,0, 2,2, 0,0, 1,1, 0,0, 0,0, 0,0, 1,1, 0,0, 1,1, 0,0, 1,1, 0,0, 1,1, 0,0],
                [0,0, 1,1, 0,0, 2,2, 0,0, 1,1, 0,0, 0,0, 0,0, 1,1, 0,0, 1,1, 0,0, 1,1, 0,0, 1,1, 0,0],

                [0,0, 1,1, 0,0, 0,0, 0,0, 1,1, 0,0, 0,0, 1,1, 1,1, 0,0, 1,1, 0,0, 1,1, 2,2, 1,1, 0,0],
                [0,0, 1,1, 0,0, 0,0, 0,0, 1,1, 0,0, 0,0, 1,1, 1,1, 0,0, 1,1, 0,0, 1,1, 2,2, 1,1, 0,0],

                [0,0, 0,0, 0,0, 1,1, 0,0, 0,0, 0,0, 0,0, 2,2, 0,0, 0,0, 0,0, 0,0, 2,2, 4,4, 0,0, 0,0],
                [0,0, 0,0, 0,0, 1,1, 0,0, 0,0, 0,0, 0,0, 2,2, 0,0, 0,0, 0,0, 0,0, 2,2, 4,4, 0,0, 0,0],

                [0,0, 0,0, 0,0, 0,0, 0,0, 0,0, 0,0, 0,0, 0,0, 0,0, 2,2, 0,0, 0,0, 0,0, 4,4, 3,3, 3,3],
                [0,0, 0,0, 0,0, 0,0, 0,0, 0,0, 0,0, 0,0, 0,0, 0,0, 2,2, 0,0, 0,0, 0,0, 4,4, 3,3, 3,3],

                [4,4, 4,4, 1,1, 1,1, 3,3, 1,1, 4,4, 4,4, 4,4, 2,2, 0,0, 0,0, 1,1, 1,1, 0,0, 1,1, 1,1],
                [4,4, 4,4, 1,1, 1,1, 3,3, 1,1, 4,4, 4,4, 4,4, 2,2, 0,0, 0,0, 1,1, 1,1, 0,0, 0,0, 0,0],

                [0,0, 0,0, 0,0, 0,0, 0,0, 1,1, 4,4, 1,1, 0,0, 1,1, 0,0, 0,0, 0,0, 0,0, 0,0, 0,0, 0,0],
                [0,0, 0,0, 0,0, 0,0, 0,0, 1,1, 4,4, 1,1, 0,0, 1,1, 0,0, 0,0, 0,0, 0,0, 0,0, 1,1, 0,0],

                [2,2, 1,1, 1,1, 1,1, 0,0, 1,1, 0,0, 1,1, 1,1, 1,1, 0,0, 1,1, 1,1, 1,1, 2,2, 1,1, 4,4],
                [2,2, 1,1, 1,1, 1,1, 0,0, 1,1, 0,0, 1,1, 1,1, 1,1, 0,0, 1,1, 1,1, 1,1, 2,2, 1,1, 4,4],

                [0,0, 1,1, 1,1, 1,1, 0,0, 0,0, 0,0, 0,0, 0,0, 0,0, 0,0, 0,0, 0,0, 0,0, 0,0, 0,0, 4,4],
                [0,0, 1,1, 1,1, 1,1, 0,0, 0,0, 0,0, 0,1, 1,1, 1,0, 0,0, 0,0, 0,0, 0,0, 0,0, 0,0, 4,4],

                [0,0, 1,1, 1,1, 1,1, 0,0, 1,1, 0,0, 0,1, 9,9, 1,0, 0,0, 1,1, 1,1, 1,1, 1,1, 1,1, 0,0],
                [0,0, 1,1, 1,1, 1,1, 0,0, 1,1, 0,0, 0,1, 9,9, 1,0, 0,0, 1,1, 1,1, 1,1, 1,1, 1,1, 0,0]]
    },
    {
        "spawnPoints": [[0,0],[8,0],[24, 0],[32, 0]],
        "playerSpawnsPos": [{"x": 12, "y": 18}, {"x": 20, "y": 18}],
        "basePos": {"x": 16, "y": 18},
        "npc": [0,0,0,0,1,1,0,0,0,0,1,1,0,1,1,0,1,1,1,1],
        "map": [[0,0,0,0,0,0,0,0,0,0,0,0,0,0,0,0,0,0,0,0,0,0,0,0,0,0,0,0,0,0,0,0,0,0],
                [0,0,0,0,0,0,0,0,0,0,0,0,0,0,0,0,0,0,0,0,0,0,0,0,0,0,0,0,0,0,0,0,0,0],
                [0,0,1,1,0,0,1,1,0,0,1,1,0,0,0,1,1,1,1,0,0,0,1,1,0,0,1,1,0,0,1,1,0,0],
                [0,0,1,1,0,0,1,1,0,0,1,1,0,0,0,1,1,1,1,0,0,0,1,1,0,0,1,1,0,0,1,1,0,0],
                [0,0,1,1,0,0,1,1,0,0,1,1,0,0,0,1,1,1,1,0,0,0,1,1,0,0,1,1,0,0,1,1,0,0],
                [0,0,1,1,0,0,1,1,0,0,1,1,0,0,0,1,1,1,1,0,0,0,1,1,0,0,1,1,0,0,1,1,0,0],
                [0,0,1,1,0,0,1,1,0,0,1,1,0,0,0,1,1,1,1,0,0,0,1,1,0,0,1,1,0,0,1,1,0,0],
                [0,0,1,1,0,0,1,1,0,0,1,1,0,0,0,1,1,1,1,0,0,0,1,1,0,0,1,1,0,0,1,1,0,0],
                [4,4,4,4,0,0,0,0,0,0,0,0,0,0,0,0,0,0,0,0,0,0,0,0,0,0,0,0,0,0,4,4,4,4],
                [4,4,4,4,0,0,0,0,0,0,0,0,0,0,0,0,0,0,0,0,0,0,0,0,0,0,0,0,0,0,4,4,4,4],
                [4,4,1,1,3,3,3,3,3,3,1,1,0,0,0,0,0,0,0,0,0,0,1,1,3,3,3,3,3,3,1,1,4,4],
                [4,4,1,1,3,3,3,3,3,3,1,1,0,0,0,0,0,0,0,0,0,0,1,1,3,3,3,3,3,3,1,1,4,4],
                [4,4,4,4,0,0,0,0,0,0,0,0,0,0,0,0,0,0,0,0,0,0,0,0,0,0,0,0,0,0,4,4,4,4],
                [4,4,4,4,0,0,0,0,0,0,0,0,0,0,0,0,0,0,0,0,0,0,0,0,0,0,0,0,0,0,4,4,4,4],
                [0,0,1,1,0,0,1,1,0,0,1,1,0,0,0,1,1,1,1,0,0,0,1,1,0,0,1,1,0,0,1,1,0,0],
                [0,0,1,1,0,0,1,1,0,0,1,1,0,0,0,0,0,0,0,0,0,0,1,1,0,0,1,1,0,0,1,1,0,0],
                [0,0,1,1,0,0,1,1,0,0,1,1,0,0,0,0,0,0,0,0,0,0,1,1,0,0,1,1,0,0,1,1,0,0],
                [0,0,1,1,0,0,1,1,0,0,1,1,0,0,0,1,1,1,1,0,0,0,1,1,0,0,1,1,0,0,1,1,0,0],
                [0,0,0,0,0,0,0,0,0,0,0,0,0,0,0,1,9,9,1,0,0,0,0,0,0,0,0,0,0,0,0,0,0,0],
                [0,0,0,0,0,0,0,0,0,0,0,0,0,0,0,1,9,9,1,0,0,0,0,0,0,0,0,0,0,0,0,0,0,0]]
    },
    {
        "spawnPoints": [[0,4],[0,14],[4, 13],[4, 4]],
        "playerSpawnsPos": [{"x": 32, "y": 5}, {"x": 28, "y": 4}],
        "basePos": {"x": 32, "y": 13},
        "npc": [0,0,0,0,1,1,0,0,0,0,1,1,0,1,1,0,1,1,1,1],
        "map": [[4,4,    4,4,    4,4,    4,4,    0,0,    0,0,    0,0,    0,0,    0,0,    0,0,    0,0,    0,0,    0,0,    0,0,    0,0,    0,1,    1,0    ],
                [4,4,    4,4,    4,4,    4,0,    0,0,    0,0,    0,0,    0,0,    0,0,    0,0,    0,0,    0,0,    0,0,    0,0,    0,0,    1,1,    1,1    ],
                
                [4,4,    4,0,    0,0,    0,0,    0,0,    0,0,    0,0,    0,0,    0,0,    0,0,    0,0,    0,0,    0,0,    0,0,    0,0,    2,2,    1,1    ],
                [0,0,    0,0,    0,0,    2,2,    2,2,    2,2,    2,2,    2,0,    0,0,    1,1,    1,1,    1,1,    0,2,    2,2,    0,0,    0,2,    1,0    ],
                
                [0,0,    0,0,    0,0,    2,1,    1,1,    1,1,    1,1,    2,0,    0,0,    1,1,    1,1,    1,1,    1,1,    1,2,    0,0,    0,0,    0,0    ],
                [0,0,    0,0,    0,0,    2,1,    0,0,    0,0,    0,0,    0,0,    0,0,    0,0,    0,0,    0,0,    0,0,    1,2,    0,0,    0,0,    0,0    ],
                
                [0,0,    0,0,    0,0,    2,1,    0,0,    0,0,    0,0,    0,0,    0,0,    0,0,    0,0,    0,0,    0,0,    1,1,    0,0,    0,0,    0,0    ],
                [0,0,    0,0,    0,0,    1,1,    0,0,    0,0,    0,0,    0,0,    0,0,    0,0,    0,0,    2,2,    0,0,    1,1,    0,0,    0,0,    0,0    ],
                
                [0,0,    0,0,    0,0,    0,0,    0,0,    0,0,    0,0,    0,0,    0,0,    0,0,    0,0,    0,2,    0,0,    0,0,    0,0,    0,0,    0,0    ],
                [0,0,    0,0,    0,0,    0,0,    0,0,    0,0,    0,0,    0,0,    0,0,    0,0,    0,0,    0,2,    0,0,    0,0,    0,0,    0,0,    0,0    ],
                
                [0,0,    0,0,    0,0,    0,0,    0,0,    2,0,    0,0,    0,0,    0,0,    0,0,    0,0,    0,0,    0,0,    0,0,    0,0,    0,0,    0,0    ],
                [0,0,    0,0,    0,0,    2,2,    0,0,    2,0,    0,0,    0,0,    0,0,    0,0,    0,0,    0,0,    0,0,    2,2,    0,0,    0,0,    0,0    ],
                
                [0,0,    0,0,    0,0,    2,1,    0,0,    2,2,    0,0,    0,0,    0,0,    0,0,    0,0,    0,0,    0,0,    1,2,    0,0,    0,0,    1,1    ],
                [0,0,    0,0,    0,0,    2,1,    0,0,    0,0,    0,0,    0,0,    0,0,    0,0,    0,0,    0,0,    0,0,    1,1,    0,0,    0,1,    9,9    ],
                
                [0,0,    0,0,    0,0,    2,1,    0,0,    0,0,    0,0,    0,0,    0,0,    0,0,    0,0,    0,0,    0,0,    1,1,    0,0,    0,1,    9,9    ],
                [0,0,    0,0,    4,4,    2,1,    1,1,    1,1,    1,1,    2,0,    0,0,    2,1,    1,1,    1,1,    1,1,    2,2,    0,0,    0,0,    1,1    ],
                
                [4,4,    4,4,    4,4,    2,2,    2,2,    2,2,    2,2,    2,0,    0,0,    2,2,    2,2,    2,2,    1,1,    2,2,    0,0,    0,0,    4,4    ],
                [4,4,    4,4,    4,4,    4,4,    0,0,    0,0,    0,0,    0,0,    0,0,    0,0,    0,0,    0,0,    0,0,    0,0,    0,0,    4,4,    4,4    ],
                
                [4,4,    4,4,    4,4,    4,0,    0,0,    0,0,    0,0,    0,0,    0,0,    0,0,    0,0,    0,0,    0,0,    0,0,    0,4,    4,4,    4,4    ],
                [4,4,    4,4,    4,4,    0,0,    0,0,    0,0,    0,0,    0,0,    0,0,    0,0,    0,0,    0,0,    0,0,    0,0,    4,4,    4,4,    4,4    ]]
    },
    {
        "spawnPoints": [[0,0],[32,0],[20, 0],[14, 0]],
        "playerSpawnsPos": [{"x": 20, "y": 18}, {"x": 12, "y": 18}],
        "basePos": {"x": 16, "y": 18},
        "npc": [1,1,0,0,1,1,0,1,0,0,1,1,0,1,1,0,1,1,1,1],
        "map": [[0,0,    0,0,    0,0,    0,0,    1,1,    0,0,    0,0,    0,0,    0,0,    0,0,    0,0,    0,0,    1,1,    0,0,    0,0,    0,0,    0,0    ],
                [0,0,    0,0,    0,0,    0,0,    1,1,    0,0,    0,0,    0,0,    0,0,    0,0,    0,0,    0,0,    1,1,    0,0,    0,0,    0,0,    0,0    ],
                
                [0,0,    0,0,    0,0,    0,0,    0,0,    0,0,    0,0,    0,0,    0,0,    0,0,    0,0,    0,0,    0,0,    0,0,    0,0,    0,0,    0,0    ],
                [0,0,    0,0,    0,0,    0,0,    0,0,    0,0,    0,0,    0,0,    0,0,    0,0,    0,0,    0,0,    0,0,    0,0,    0,0,    0,0,    0,0    ],
                
                [0,0,    0,0,    0,0,    0,0,    0,0,    0,0,    0,0,    0,0,    0,0,    0,0,    0,0,    0,0,    0,0,    0,0,    0,0,    0,0,    0,0    ],
                [0,0,    0,0,    0,0,    0,0,    0,0,    0,0,    4,4,    2,2,    2,2,    2,2,    0,0,    0,0,    0,0,    0,0,    0,0,    0,4,    4,4    ],
                
                [0,0,    2,1,    0,0,    0,0,    0,0,    0,0,    4,4,    2,2,    2,2,    2,2,    0,0,    0,0,    0,0,    0,0,    0,0,    4,2,    4,4    ],
                [0,0,    2,2,    1,0,    0,0,    2,2,    0,0,    4,4,    2,2,    0,0,    0,0,    0,0,    0,0,    0,2,    2,0,    0,4,    2,2,    4,4    ],
                
                [1,1,    2,2,    2,1,    1,1,    2,2,    0,0,    4,4,    2,2,    0,0,    0,0,    0,0,    0,0,    0,2,    2,0,    4,2,    2,2,    4,4    ],
                [0,0,    2,2,    1,0,    0,0,    0,0,    4,4,    4,4,    2,2,    0,0,    2,2,    2,2,    2,0,    0,0,    0,0,    4,2,    2,2,    4,4    ],
                
                [0,0,    2,1,    0,0,    0,0,    0,0,    4,4,    4,4,    2,2,    0,0,    2,2,    2,2,    2,0,    0,0,    0,0,    0,4,    2,2,    4,4    ],
                [0,0,    0,0,    0,0,    0,0,    0,0,    4,4,    3,3,    2,2,    0,0,    2,2,    1,1,    0,0,    0,0,    0,0,    0,0,    4,2,    4,4    ],
                
                [0,0,    0,0,    0,0,    0,0,    0,0,    4,4,    3,3,    2,2,    1,1,    2,2,    1,0,    0,0,    0,0,    0,0,    0,0,    0,1,    4,4    ],
                [0,0,    0,2,    2,1,    1,2,    2,0,    0,0,    0,0,    0,0,    0,0,    0,0,    0,0,    0,0,    0,0,    0,0,    0,0,    0,1,    0,0    ],
                
                [0,0,    0,0,    0,0,    0,0,    2,0,    0,0,    0,0,    0,0,    0,0,    0,0,    0,0,    0,0,    2,2,    2,2,    2,0,    0,1,    0,0    ],
                [0,0,    0,0,    0,0,    0,0,    2,0,    0,0,    0,0,    0,0,    0,0,    0,0,    0,0,    0,0,    0,0,    2,2,    0,0,    0,1,    0,0    ],
                
                [0,0,    0,0,    0,0,    0,0,    0,0,    0,0,    0,0,    0,0,    0,0,    0,0,    0,0,    0,0,    0,0,    2,0,    0,0,    0,1,    0,0    ],
                [0,0,    0,0,    0,0,    0,0,    0,0,    0,0,    0,0,    0,1,    1,1,    1,0,    0,0,    0,0,    0,0,    2,1,    1,1,    1,1,    0,0    ],
                
                [2,2,    1,0,    0,0,    0,0,    0,0,    0,0,    0,0,    0,1,    9,9,    1,0,    0,0,    0,0,    0,0,    0,0,    0,0,    0,0,    0,0    ],
                [2,2,    1,1,    0,0,    0,0,    0,0,    0,0,    0,0,    0,1,    9,9,    1,0,    0,0,    0,0,    0,0,    0,0,    0,0,    0,0,    0,0    ]]
    } 
]